00000000W0000000
0W0D0W00A00T00W0
0WTD0WLLLLLL00W0
0W0D0W0T0000A0W0
0W0W0W000T0000W0
0000AW00WWWWDDW0
0WWW0W00000LA0W0
0000T000W00L0000
0WWWWW00W00W000W
K0000000WA000000
